Player,Tm,W/L%,WS,G,GS,MP,FG,FGA,2P,2PA,3P,3PA,FT,FTA,ORB,DRB,TRB,AST,STL,BLK,TOV,PF,PTS,FG%,2P%,3P%,FT%
Michael Jordan,CHI,.744,20.3,82,82,3034,990,1837,961,1744,29,93,571,671,118,374,492,453,223,83,202,229,2580,.539,.551,.312,.851
David Robinson,SAS,.671,17.0,82,81,3095,754,1366,753,1359,1,7,592,777,335,728,1063,208,127,320,270,264,2101,.552,.554,.143,.762
Karl Malone,UTA,.659,15.5,82,82,3302,847,1608,843,1594,4,14,684,888,236,731,967,270,89,79,244,268,2382,.527,.529,.286,.770
Magic Johnson,LAL,.707,15.4,79,79,2933,466,976,386,726,80,250,519,573,105,446,551,989,102,17,314,150,1531,.477,.532,.320,.906
John Stockton,UTA,.659,14.0,82,82,3103,496,978,438,810,58,168,363,434,46,191,237,1164,234,16,298,233,1413,.507,.541,.345,.836
Charles Barkley,PHI,.537,13.4,67,67,2498,665,1167,621,1012,44,155,475,658,258,422,680,284,110,33,210,173,1849,.570,.614,.284,.722
Terry Porter,POR,.768,13.0,81,81,2665,486,944,356,631,130,313,279,339,52,230,282,649,158,12,189,151,1381,.515,.564,.415,.823
Kevin Johnson,PHO,.671,12.7,77,76,2772,591,1145,582,1101,9,44,519,616,54,217,271,781,163,11,269,174,1710,.516,.529,.205,.843
Reggie Miller,IND,.500,12.5,82,82,2972,596,1164,484,842,112,322,551,600,81,200,281,331,109,13,163,165,1855,.512,.575,.348,.918
Clyde Drexler,POR,.768,12.4,82,82,2852,645,1338,584,1147,61,191,416,524,212,334,546,493,144,60,232,226,1767,.482,.509,.319,.794
Chris Mullin,GSW,.537,12.2,82,82,3315,777,1449,737,1316,40,133,513,580,141,302,443,329,173,63,245,176,2107,.536,.560,.301,.884
Dominique Wilkins,ATL,.524,11.4,81,81,3078,770,1640,685,1391,85,249,476,574,261,471,732,265,123,65,201,156,2101,.470,.492,.341,.829
Scottie Pippen,CHI,.744,11.2,82,82,3014,600,1153,579,1085,21,68,240,340,163,432,595,511,193,93,232,270,1461,.520,.534,.309,.706
Otis Thorpe,HOU,.634,10.4,82,82,3039,549,988,546,981,3,7,334,480,287,559,846,197,73,20,217,278,1435,.556,.557,.429,.696
Horace Grant,CHI,.744,10.3,78,76,2641,401,733,400,727,1,6,197,277,266,393,659,178,95,69,92,203,1000,.547,.550,.167,.711
Patrick Ewing,NYK,.476,10.0,81,81,3104,845,1645,845,1639,0,6,464,623,194,711,905,244,80,258,291,287,2154,.514,.516,.000,.745
Robert Parish,BOS,.683,10.0,81,81,2441,485,811,485,810,0,1,237,309,271,585,856,66,66,103,153,197,1207,.598,.599,.000,.767
Joe Dumars,DET,.610,9.9,80,80,3046,622,1292,608,1247,14,45,371,417,62,125,187,443,89,7,189,135,1629,.481,.488,.311,.890
Tim Hardaway,GSW,.537,9.9,82,82,3215,739,1551,642,1299,97,252,306,381,87,245,332,793,214,12,270,228,1881,.476,.494,.385,.803
Hersey Hawkins,PHI,.537,9.8,80,80,3110,590,1251,482,981,108,270,479,550,48,262,310,299,178,39,213,182,1767,.472,.491,.400,.871
Larry Nance,CLE,.402,9.8,80,78,2927,635,1211,633,1203,2,8,265,330,201,485,686,237,66,200,131,219,1537,.524,.526,.250,.803
Jeff Hornacek,PHO,.671,9.7,80,77,2733,544,1051,483,905,61,146,201,224,74,247,321,409,111,16,130,185,1350,.518,.534,.418,.897
Brad Daugherty,CLE,.402,9.0,76,76,2946,605,1155,605,1152,0,3,435,579,177,653,830,253,74,46,211,191,1645,.524,.525,.000,.751
Detlef Schrempf,IND,.500,9.0,82,3,2632,432,831,417,791,15,40,441,539,178,482,660,301,58,22,175,262,1320,.520,.527,.375,.818
Kenny Smith,HOU,.634,9.0,78,78,2699,522,1003,473,868,49,135,287,340,36,127,163,554,106,11,237,131,1380,.520,.545,.363,.844
James Worthy,LAL,.707,9.0,78,74,3008,716,1455,690,1365,26,90,212,266,107,249,356,275,104,35,127,117,1670,.492,.505,.289,.797
Sean Elliott,SAS,.671,8.8,82,82,3044,478,976,458,912,20,64,325,402,142,314,456,238,69,33,147,190,1301,.490,.502,.313,.808
Dennis Rodman,DET,.610,8.7,82,77,2747,276,560,270,530,6,30,111,176,361,665,1026,85,65,55,94,281,669,.493,.509,.200,.631
Jay Humphries,MIL,.585,8.6,80,80,2726,482,960,422,799,60,161,191,239,57,163,220,538,129,7,151,237,1215,.502,.528,.373,.799
Hakeem Olajuwon,HOU,.634,8.6,56,50,2062,487,959,487,955,0,4,213,277,219,551,770,131,121,221,174,221,1187,.508,.510,.000,.769
Buck Williams,POR,.768,8.5,80,80,2582,358,595,358,595,0,0,217,308,227,524,751,97,47,47,137,247,933,.602,.602,,.705
Vlade Divac,LAL,.707,8.3,82,81,2310,360,637,355,623,5,14,196,279,205,461,666,92,106,127,146,247,921,.565,.570,.357,.703
Kevin Gamble,BOS,.683,8.3,82,76,2706,548,933,548,926,0,7,185,227,85,182,267,256,100,34,148,237,1281,.587,.592,.000,.815
Bill Laimbeer,DET,.610,8.0,82,81,2668,372,778,335,653,37,125,123,147,173,564,737,157,38,56,98,242,904,.478,.513,.296,.837
Sam Perkins,LAL,.707,8.0,73,66,2504,368,744,350,680,18,64,229,279,167,371,538,108,64,78,103,247,983,.495,.515,.281,.821
Kevin McHale,BOS,.683,7.9,68,10,2067,504,912,489,875,15,37,228,275,145,335,480,126,25,146,140,194,1251,.553,.559,.405,.829
Ricky Pierce,TOT,,7.9,78,2,2167,561,1156,515,1040,46,116,430,471,67,124,191,168,60,13,147,170,1598,.485,.495,.397,.913
Alvin Robertson,MIL,.585,7.7,81,81,2598,438,904,415,841,23,63,199,263,191,268,459,444,246,16,212,273,1098,.485,.493,.365,.757
Derek Harper,DAL,.341,7.6,77,77,2879,572,1226,483,980,89,246,286,391,59,174,233,548,147,14,177,222,1519,.467,.493,.362,.731
Reggie Lewis,BOS,.683,7.5,79,79,2878,598,1219,597,1206,1,13,281,340,119,291,410,201,98,85,147,234,1478,.491,.495,.077,.826
Charles Smith,LAC,.378,7.4,74,74,2703,548,1168,548,1161,0,7,384,484,216,392,608,134,81,145,165,267,1480,.469,.472,.000,.793
Dan Majerle,PHO,.671,7.2,77,7,2281,397,821,367,735,30,86,227,298,168,250,418,216,106,40,114,162,1051,.484,.499,.349,.762
Mitch Richmond,GSW,.537,7.1,77,77,3027,703,1424,663,1309,40,115,394,465,147,305,452,238,126,34,230,207,1840,.494,.506,.348,.847
Scott Skiles,ORL,.378,7.0,79,66,2714,462,1039,369,811,93,228,340,377,57,213,270,660,89,4,252,192,1357,.445,.455,.408,.902
Danny Schayes,MIL,.585,6.8,82,38,2228,298,597,298,592,0,5,274,328,174,361,535,98,55,61,106,264,870,.499,.503,.000,.835
Harvey Grant,WSB,.366,6.7,77,76,2842,609,1224,607,1209,2,15,185,249,179,378,557,204,91,61,125,232,1405,.498,.502,.133,.743
Jerome Kersey,POR,.768,6.7,73,72,2359,424,887,420,874,4,13,232,327,169,312,481,227,101,76,149,251,1084,.478,.481,.308,.709
Larry Bird,BOS,.683,6.6,60,60,2277,462,1017,385,819,77,198,163,183,53,456,509,431,108,58,187,118,1164,.454,.470,.389,.891
Byron Scott,LAL,.707,6.6,82,82,2630,501,1051,430,832,71,219,118,148,54,192,246,177,95,21,85,146,1191,.477,.517,.324,.797
Mark West,PHO,.671,6.5,82,64,1957,247,382,247,382,0,0,135,206,171,393,564,37,32,161,86,266,629,.647,.647,,.655
Derrick McKey,SEA,.500,6.4,73,55,2503,438,847,434,828,4,19,235,278,172,251,423,169,91,56,158,220,1115,.517,.524,.211,.845
Michael Adams,DEN,.244,6.3,66,66,2346,560,1421,393,857,167,564,465,529,58,198,256,693,147,6,240,162,1752,.394,.459,.296,.879
Doc Rivers,ATL,.524,6.3,79,79,2586,444,1020,356,758,88,262,221,262,47,206,253,340,148,47,125,216,1197,.435,.470,.336,.844
Danny Ainge,POR,.768,6.2,80,0,1710,337,714,235,463,102,251,114,138,45,160,205,285,63,13,100,195,890,.472,.508,.406,.826
Charles Oakley,NYK,.476,6.2,76,74,2739,307,595,307,593,0,2,239,305,305,615,920,204,62,17,215,288,853,.516,.518,.000,.784
A.C. Green,LAL,.707,6.1,82,21,2164,258,542,247,487,11,55,223,302,201,315,516,71,59,23,99,117,750,.476,.507,.200,.738
Shawn Kemp,SEA,.500,6.1,81,66,2442,462,909,460,897,2,12,288,436,267,412,679,144,77,123,202,319,1214,.508,.513,.167,.661
Vernon Maxwell,HOU,.634,5.9,82,79,2870,504,1247,332,737,172,510,217,296,41,197,238,303,127,15,171,179,1397,.404,.450,.337,.733
Pooh Richardson,MIN,.354,5.9,82,82,3154,635,1350,593,1222,42,128,89,165,82,204,286,734,131,13,174,114,1401,.470,.485,.328,.539
Brian Shaw,BOS,.683,5.9,79,79,2772,442,942,439,915,3,27,204,249,104,266,370,602,105,34,223,206,1091,.469,.480,.111,.819
Derrick Coleman,NJN,.317,5.8,74,68,2602,514,1100,501,1062,13,38,323,442,269,490,759,163,71,99,217,217,1364,.467,.472,.342,.731
John Paxson,CHI,.744,5.7,82,82,1971,317,578,275,482,42,96,34,41,15,76,91,297,62,3,69,136,710,.548,.571,.438,.829
Rod Strickland,SAS,.671,5.7,58,56,2076,314,651,303,618,11,33,161,211,57,162,219,463,117,11,156,125,800,.482,.490,.333,.763
Kiki Vandeweghe,NYK,.476,5.7,75,72,2420,458,927,407,786,51,141,259,288,78,102,180,110,42,10,108,122,1226,.494,.518,.362,.899
Micheal Williams,IND,.500,5.7,73,37,1706,261,523,260,516,1,7,290,330,49,127,176,348,150,17,150,202,813,.499,.504,.143,.879
Terry Cummings,SAS,.671,5.6,67,62,2195,503,1039,496,1006,7,33,164,240,194,327,521,157,61,30,131,225,1177,.484,.493,.212,.683
Moses Malone,ATL,.524,5.6,82,15,1912,280,598,280,591,0,7,309,372,271,396,667,68,30,74,137,134,869,.468,.474,.000,.831
Felton Spencer,MIN,.354,5.6,81,46,2099,195,381,195,380,0,1,182,252,272,369,641,25,48,121,77,337,572,.512,.513,.000,.722
Mark Aguirre,DET,.610,5.5,78,13,2006,420,909,396,831,24,78,240,317,134,240,374,139,47,20,128,209,1104,.462,.477,.308,.757
Rolando Blackman,DAL,.341,5.5,80,80,2965,634,1316,594,1202,40,114,282,326,63,193,256,301,69,19,159,153,1590,.482,.494,.351,.865
Mark Eaton,UTA,.659,5.5,80,80,2580,169,292,169,292,0,0,71,112,182,485,667,51,39,188,99,298,409,.579,.579,,.634
Eddie Johnson,TOT,,5.5,81,27,2085,543,1122,504,1002,39,120,229,257,107,164,271,111,58,9,122,181,1354,.484,.503,.325,.891
Antoine Carr,SAC,.305,5.4,77,48,2527,628,1228,628,1225,0,3,295,389,163,257,420,191,45,101,171,315,1551,.511,.513,.000,.758
Tom Chambers,PHO,.671,5.4,76,75,2475,556,1271,536,1198,20,73,379,459,104,386,490,194,65,52,177,235,1511,.437,.447,.274,.826
Tyrone Corbin,MIN,.354,5.4,82,82,3196,587,1311,585,1301,2,10,296,371,185,404,589,347,162,53,209,257,1472,.448,.450,.200,.798
Sherman Douglas,MIA,.293,5.4,73,73,2562,532,1055,528,1024,4,31,284,414,78,131,209,624,121,5,270,178,1352,.504,.516,.129,.686
Spud Webb,ATL,.524,5.4,75,64,2197,359,803,305,635,54,168,231,266,41,133,174,417,118,6,146,180,1003,.447,.480,.321,.868
Rod Higgins,GSW,.537,5.3,82,9,2024,259,559,186,339,73,220,185,226,109,245,354,113,52,37,65,198,776,.463,.549,.332,.819
Rodney McCray,DAL,.341,5.3,74,68,2561,336,679,323,640,13,39,159,198,153,407,560,259,70,51,129,203,844,.495,.505,.333,.803
Maurice Cheeks,NYK,.476,5.2,76,64,2147,241,483,236,463,5,20,105,129,22,151,173,435,128,10,108,138,592,.499,.510,.250,.814
Danny Manning,LAC,.378,5.2,73,47,2197,470,905,470,902,0,3,219,306,169,257,426,196,117,62,188,281,1159,.519,.521,.000,.716
Olden Polynice,TOT,,5.2,79,30,2092,316,564,316,563,0,1,146,252,220,333,553,42,43,32,88,192,778,.560,.561,.000,.579
Jeff Malone,UTA,.659,5.1,69,69,2466,525,1034,524,1028,1,6,231,252,36,170,206,143,50,6,108,128,1282,.508,.510,.167,.917
Xavier McDaniel,TOT,,5.1,81,79,2634,590,1186,590,1178,0,8,193,267,173,384,557,187,76,46,184,264,1373,.497,.501,.000,.723
Sam Mitchell,MIN,.354,5.1,82,60,3121,445,1010,445,1001,0,9,307,396,188,332,520,133,66,57,104,338,1197,.441,.445,.000,.775
Grant Long,MIA,.293,5.0,80,66,2514,276,561,275,555,1,6,181,230,225,343,568,176,119,43,156,295,734,.492,.495,.167,.787
Willie Anderson,SAS,.671,4.8,75,75,2592,453,991,446,956,7,35,170,213,68,283,351,358,79,46,167,226,1083,.457,.467,.200,.798
Muggsy Bogues,CHH,.317,4.8,81,46,2299,241,524,241,512,0,12,86,108,58,158,216,669,137,3,120,160,568,.460,.471,.000,.796
Ken Norman,LAC,.378,4.8,70,45,2309,520,1037,514,1005,6,32,173,275,177,320,497,159,63,63,139,192,1219,.501,.511,.188,.629
John Salley,DET,.610,4.8,74,1,1649,179,377,179,376,0,1,186,256,137,190,327,70,52,112,91,240,544,.475,.476,.000,.727
Frank Brickowski,MIL,.585,4.7,75,73,1912,372,706,372,704,0,2,198,248,129,297,426,131,86,43,160,255,942,.527,.528,.000,.798
Ed Pinckney,BOS,.683,4.7,70,16,1165,131,243,131,242,0,1,104,116,155,186,341,45,61,43,45,147,366,.539,.541,.000,.897
Reggie Theus,NJN,.317,4.7,81,81,2955,583,1247,531,1103,52,144,292,343,69,160,229,378,85,35,252,231,1510,.468,.481,.361,.851
Armen Gilliam,TOT,,4.6,75,75,2644,487,1001,487,999,0,2,268,329,220,378,598,105,69,53,174,185,1242,.487,.487,.000,.815
Buck Johnson,HOU,.634,4.6,73,70,2279,416,873,414,858,2,15,157,216,108,222,330,142,81,47,122,240,991,.477,.483,.133,.727
Sedale Threatt,SEA,.500,4.6,80,57,2066,433,835,423,800,10,35,137,173,25,74,99,273,113,8,138,191,1013,.519,.529,.286,.792
Chris Morris,NJN,.317,4.5,79,68,2553,409,962,364,783,45,179,179,244,210,311,521,220,138,96,167,248,1042,.425,.465,.251,.734
Vern Fleming,IND,.500,4.4,69,45,1929,356,671,352,653,4,18,161,221,83,131,214,369,76,13,137,116,877,.531,.539,.222,.729
Rick Mahorn,PHI,.537,4.4,80,74,2439,261,559,261,550,0,9,189,240,151,470,621,118,79,56,127,276,711,.467,.475,.000,.788
Glen Rice,MIA,.293,4.4,77,77,2646,550,1193,479,1009,71,184,171,209,85,296,381,189,101,26,166,216,1342,.461,.475,.386,.818
