Player,Tm,W/L%,WS,G,GS,MP,FG,FGA,2P,2PA,3P,3PA,FT,FTA,ORB,DRB,TRB,AST,STL,BLK,TOV,PF,PTS,FG%,2P%,3P%,FT%
Michael Jordan,CHI,.695,17.2,78,78,3067,992,2003,911,1773,81,230,476,569,135,387,522,428,221,61,207,188,2541,.495,.514,.352,.837
Hakeem Olajuwon,HOU,.671,15.8,82,82,3242,848,1603,848,1595,0,8,444,570,283,785,1068,291,150,342,262,305,2140,.529,.532,.000,.779
Karl Malone,UTA,.573,15.4,82,82,3099,797,1443,793,1423,4,20,619,836,227,692,919,308,124,85,240,261,2217,.552,.557,.200,.740
Charles Barkley,PHO,.756,14.4,76,76,2859,716,1376,649,1156,67,220,445,582,237,691,928,385,119,74,233,196,1944,.520,.561,.305,.765
David Robinson,SAS,.598,13.2,82,82,3211,676,1348,673,1331,3,17,561,766,229,727,956,301,127,264,241,239,1916,.501,.506,.176,.732
Brad Daugherty,CLE,.659,12.7,71,71,2691,520,911,519,909,1,2,391,492,164,562,726,312,53,56,150,174,1432,.571,.571,.500,.795
Reggie Miller,IND,.500,11.3,82,82,2954,571,1193,404,774,167,419,427,485,67,191,258,262,120,26,145,182,1736,.479,.522,.399,.880
Larry Nance,CLE,.659,10.7,77,77,2753,533,971,533,967,0,4,202,247,184,484,668,223,54,198,107,223,1268,.549,.551,.000,.818
Patrick Ewing,NYK,.732,10.6,81,81,3003,779,1550,778,1543,1,7,400,556,191,789,980,151,74,161,265,286,1959,.503,.504,.143,.719
John Stockton,UTA,.573,10.6,82,82,2863,437,899,365,712,72,187,293,367,64,173,237,987,199,21,266,224,1239,.486,.513,.385,.798
Dominique Wilkins,ATL,.524,10.5,71,70,2647,741,1584,621,1268,120,316,519,627,187,295,482,227,70,27,184,116,2121,.468,.490,.380,.828
Shaquille O'Neal,ORL,.500,10.4,81,81,3071,733,1304,733,1302,0,2,427,721,342,780,1122,152,60,286,307,321,1893,.562,.563,.000,.592
Detlef Schrempf,IND,.500,10.4,82,60,3098,517,1085,509,1033,8,52,525,653,210,570,780,493,79,27,243,305,1567,.476,.493,.154,.804
Dan Majerle,PHO,.756,9.8,82,82,3199,509,1096,342,658,167,438,203,261,120,263,383,311,138,33,133,180,1388,.464,.520,.381,.778
Mark Price,CLE,.659,9.8,75,74,2380,477,986,355,693,122,293,289,305,37,164,201,602,89,11,196,105,1365,.484,.512,.416,.948
Larry Johnson,CHH,.537,9.6,82,82,3323,728,1385,710,1314,18,71,336,438,281,583,864,353,53,27,227,187,1810,.526,.540,.254,.767
Derrick Coleman,NJN,.524,9.5,76,73,2759,564,1226,541,1127,23,99,421,521,247,605,852,276,92,126,243,210,1572,.460,.480,.232,.808
Joe Dumars,DET,.488,9.1,77,77,3094,677,1454,565,1155,112,299,343,397,63,85,148,308,78,7,138,141,1809,.466,.489,.375,.864
Horace Grant,CHI,.695,9.1,77,77,2745,421,829,420,824,1,5,174,281,341,388,729,201,89,96,110,218,1017,.508,.510,.200,.619
Shawn Kemp,SEA,.671,9.1,78,68,2582,515,1047,515,1043,0,4,358,503,287,546,833,155,119,146,217,327,1388,.492,.494,.000,.712
Dikembe Mutombo,DEN,.439,8.8,82,82,3029,398,781,398,781,0,0,335,492,344,726,1070,147,43,287,216,284,1131,.510,.510,,.681
Terry Porter,POR,.622,8.8,81,81,2883,503,1108,360,763,143,345,327,388,58,258,316,419,101,10,199,122,1476,.454,.472,.414,.843
A.C. Green,LAL,.476,8.6,82,55,2819,379,706,363,660,16,46,277,375,287,424,711,116,88,39,116,149,1051,.537,.550,.348,.739
Scottie Pippen,CHI,.695,8.6,81,81,3123,628,1327,606,1234,22,93,232,350,203,418,621,507,173,73,246,219,1510,.473,.491,.237,.663
Hersey Hawkins,PHI,.317,8.5,81,81,2977,551,1172,429,865,122,307,419,487,91,255,346,317,137,30,180,189,1643,.470,.496,.397,.860
Drazen Petrovic,NJN,.524,8.4,70,67,2660,587,1134,512,967,75,167,315,362,42,148,190,247,94,13,204,237,1564,.518,.529,.449,.870
Reggie Lewis,BOS,.585,8.3,80,80,3144,663,1410,649,1350,14,60,326,376,88,259,347,298,118,77,133,248,1666,.470,.481,.233,.867
Alonzo Mourning,CHH,.537,8.2,78,78,2644,572,1119,572,1116,0,3,495,634,263,542,805,76,27,271,236,286,1639,.511,.513,.000,.781
Kenny Smith,HOU,.671,8.2,82,82,2422,387,744,291,525,96,219,195,222,28,132,160,446,80,7,163,110,1065,.520,.554,.438,.878
LaPhonso Ellis,DEN,.439,8.0,82,82,2749,483,958,481,945,2,13,237,317,274,470,744,151,72,111,153,293,1205,.504,.509,.154,.748
Scott Skiles,ORL,.500,8.0,78,78,3086,416,891,336,656,80,235,289,324,52,238,290,735,86,2,267,244,1201,.467,.512,.340,.892
Mark Jackson,LAC,.500,7.9,82,81,3117,459,945,437,863,22,82,241,300,129,259,388,724,136,12,220,158,1181,.486,.506,.268,.803
Danny Manning,LAC,.500,7.9,79,77,2761,702,1379,694,1349,8,30,388,484,198,322,520,207,108,101,230,323,1800,.509,.514,.267,.802
Gary Payton,SEA,.671,7.8,82,78,2548,476,963,469,929,7,34,151,196,95,186,281,399,177,21,148,250,1110,.494,.505,.206,.770
Nick Anderson,ORL,.500,7.7,79,76,2920,594,1324,506,1075,88,249,298,402,122,355,477,265,128,56,164,200,1574,.449,.471,.353,.741
Ricky Pierce,SEA,.671,7.7,77,72,2218,524,1071,482,958,42,113,313,352,58,134,192,220,100,7,160,167,1403,.489,.503,.372,.889
Micheal Williams,MIN,.232,7.6,76,76,2661,353,791,327,684,26,107,419,462,84,189,273,661,165,23,227,268,1151,.446,.478,.243,.907
B.J. Armstrong,CHI,.695,7.5,82,74,2492,408,818,345,679,63,139,130,151,27,122,149,330,66,6,83,169,1009,.499,.508,.453,.861
Tim Hardaway,GSW,.415,7.5,66,66,2609,522,1168,420,859,102,309,273,367,60,203,263,699,116,12,220,152,1419,.447,.489,.330,.744
John Starks,NYK,.732,7.5,80,51,2477,513,1199,405,863,108,336,263,331,54,150,204,404,91,12,173,234,1397,.428,.469,.321,.795
Anthony Mason,NYK,.732,7.4,81,0,2482,316,629,316,629,0,0,199,292,231,409,640,170,43,19,137,240,831,.502,.502,,.682
Rod Strickland,POR,.622,7.4,78,35,2474,396,816,392,786,4,30,273,381,120,217,337,559,131,24,199,153,1069,.485,.499,.133,.717
Charles Oakley,NYK,.732,7.3,82,82,2230,219,431,219,430,0,1,127,176,288,420,708,126,85,15,124,289,565,.508,.509,.000,.722
Chris Morris,NJN,.524,7.2,77,57,2302,436,907,419,831,17,76,197,248,227,227,454,106,144,52,119,171,1086,.481,.504,.224,.794
Sedale Threatt,LAL,.476,7.1,82,82,2893,522,1028,508,975,14,53,177,215,47,226,273,564,142,11,173,248,1235,.508,.521,.264,.823
Mookie Blaylock,ATL,.524,7.0,80,78,2820,414,964,296,649,118,315,123,169,89,191,280,671,203,23,187,156,1069,.429,.456,.375,.728
Dale Davis,IND,.500,6.9,82,82,2264,304,535,304,535,0,0,119,225,291,432,723,69,63,148,79,274,727,.568,.568,,.529
Sam Perkins,TOT,,6.9,79,62,2351,381,799,357,728,24,71,250,305,163,361,524,156,60,82,108,225,1036,.477,.490,.338,.820
Robert Parish,BOS,.585,6.8,79,79,2146,416,777,416,777,0,0,162,235,246,494,740,61,57,107,120,201,994,.535,.535,,.689
Clifford Robinson,POR,.622,6.8,82,12,2575,632,1336,613,1259,19,77,287,416,165,377,542,182,98,163,173,287,1570,.473,.487,.247,.690
Tyrone Corbin,UTA,.573,6.7,82,58,2555,385,766,385,761,0,5,180,218,194,325,519,173,108,32,108,252,950,.503,.506,.000,.826
Kevin Gamble,BOS,.585,6.6,82,58,2541,459,906,407,767,52,139,123,149,46,200,246,226,86,37,81,185,1093,.507,.531,.374,.826
Derrick McKey,SEA,.671,6.6,77,68,2439,387,780,347,668,40,112,220,297,121,206,327,197,105,58,152,208,1034,.496,.519,.357,.741
Charles Smith,NYK,.732,6.6,81,68,2172,358,764,358,762,0,2,287,367,170,262,432,142,48,96,155,254,1003,.469,.470,.000,.782
Grant Long,MIA,.439,6.5,76,62,2728,397,847,391,821,6,26,261,341,197,371,568,182,104,31,133,264,1061,.469,.476,.231,.765
Doc Rivers,NYK,.732,6.5,77,45,1886,216,494,177,371,39,123,133,162,26,166,192,405,123,9,114,215,604,.437,.477,.317,.821
Rony Seikaly,MIA,.439,6.5,72,64,2456,417,868,416,860,1,8,397,540,259,587,846,100,38,83,203,260,1232,.480,.484,.125,.735
Dee Brown,BOS,.585,6.4,80,48,2254,328,701,302,619,26,82,192,242,45,201,246,461,138,32,136,203,874,.468,.488,.317,.793
Dale Ellis,SAS,.598,6.4,82,76,2731,545,1092,426,795,119,297,157,197,81,231,312,107,78,18,111,179,1366,.499,.536,.401,.797
Jeff Hornacek,PHI,.317,6.3,79,78,2860,582,1239,485,990,97,249,250,289,84,258,342,548,131,21,222,203,1511,.470,.490,.390,.865
Glen Rice,MIA,.439,6.3,82,82,3082,582,1324,434,938,148,386,242,295,92,332,424,180,92,25,157,201,1554,.440,.463,.383,.820
Danny Ainge,PHO,.756,6.2,80,0,2163,337,730,187,358,150,372,123,145,49,165,214,260,69,8,113,175,947,.462,.522,.403,.848
Michael Cage,SEA,.671,6.2,82,66,2156,219,416,219,415,0,1,61,130,268,391,659,69,76,46,59,183,499,.526,.528,.000,.469
Cedric Ceballos,PHO,.756,6.2,74,46,1607,381,662,381,660,0,2,187,258,172,236,408,77,54,28,106,103,949,.576,.577,.000,.725
Craig Ehlo,CLE,.659,6.2,82,73,2559,385,785,292,541,93,244,86,120,113,290,403,254,104,22,124,170,949,.490,.540,.381,.717
Sean Elliott,SAS,.598,6.1,70,70,2604,451,918,414,814,37,104,268,337,85,237,322,265,68,28,152,132,1207,.491,.509,.356,.795
Eric Murdock,MIL,.341,6.1,79,78,2437,438,936,407,817,31,119,231,296,95,189,284,603,174,7,207,177,1138,.468,.498,.261,.780
Buck Williams,POR,.622,6.1,82,82,2498,270,528,270,527,0,1,138,214,232,458,690,75,81,61,101,270,678,.511,.512,.000,.645
Clyde Drexler,POR,.622,6.0,49,49,1671,350,816,319,683,31,133,245,292,126,183,309,278,95,37,115,159,976,.429,.467,.233,.839
Ron Harper,LAC,.500,6.0,80,77,2970,542,1203,490,1017,52,186,307,399,117,308,425,360,177,73,222,212,1443,.451,.482,.280,.769
Otis Thorpe,HOU,.671,6.0,72,69,2357,385,690,385,688,0,2,153,256,219,370,589,181,43,19,151,234,923,.558,.560,.000,.598
Kevin Willis,ATL,.524,6.0,80,80,2878,616,1218,609,1189,7,29,196,300,335,693,1028,165,68,41,213,264,1435,.506,.512,.241,.653
Muggsy Bogues,CHH,.537,5.9,81,80,2833,331,730,325,704,6,26,140,168,51,247,298,711,161,5,154,179,808,.453,.462,.231,.833
Reggie Williams,DEN,.439,5.9,79,79,2722,535,1167,502,1045,33,122,238,296,132,296,428,295,126,76,194,284,1341,.458,.480,.270,.804
Bimbo Coles,MIA,.439,5.7,81,37,2232,318,686,276,549,42,137,177,220,58,108,166,373,80,11,108,199,855,.464,.503,.307,.805
Blue Edwards,MIL,.341,5.7,82,81,2729,554,1083,517,977,37,106,237,300,123,259,382,214,129,45,175,242,1382,.512,.529,.349,.790
Vlade Divac,LAL,.476,5.6,82,69,2525,397,819,376,744,21,75,235,341,220,509,729,232,128,140,214,311,1050,.485,.505,.280,.689
Nate McMillan,SEA,.671,5.6,73,25,1977,213,459,188,394,25,65,95,134,84,222,306,384,173,33,139,240,546,.464,.477,.385,.709
Antoine Carr,SAS,.598,5.5,71,46,1947,379,705,379,700,0,5,174,224,107,281,388,97,35,87,96,264,932,.538,.541,.000,.777
Dennis Rodman,DET,.488,5.5,62,55,2410,183,429,168,356,15,73,87,163,367,765,1132,102,48,45,103,201,468,.427,.472,.205,.534
Bill Laimbeer,DET,.488,5.4,79,41,1933,292,574,282,547,10,27,93,104,110,309,419,127,46,40,59,212,687,.509,.516,.370,.894
Avery Johnson,SAS,.598,5.2,75,49,2030,256,510,256,502,0,8,144,182,20,126,146,561,85,16,145,141,656,.502,.510,.000,.791
Ken Norman,LAC,.500,5.2,76,71,2477,498,975,488,937,10,38,131,220,209,362,571,165,59,58,125,156,1137,.511,.521,.263,.595
Mahmoud Abdul-Rauf,DEN,.439,5.1,81,81,2710,633,1407,563,1210,70,197,217,232,51,174,225,344,84,8,187,179,1553,.450,.465,.355,.935
Mario Elie,POR,.622,5.1,82,7,1757,240,524,195,395,45,129,183,214,59,157,216,177,74,20,89,145,708,.458,.494,.349,.855
Kevin Johnson,PHO,.756,5.1,49,47,1643,282,565,281,557,1,8,226,276,30,74,104,384,85,19,151,100,791,.499,.504,.125,.819
Donald Royal,ORL,.500,5.1,77,0,1636,194,391,194,388,0,3,318,390,116,179,295,80,36,25,113,179,706,.496,.500,.000,.815
Harvey Grant,WSB,.268,5.0,72,72,2667,560,1149,559,1139,1,10,218,300,133,279,412,205,72,44,90,168,1339,.487,.491,.100,.727
Christian Laettner,MIN,.232,5.0,81,81,2823,503,1061,499,1021,4,40,462,553,171,537,708,223,105,83,275,290,1472,.474,.489,.100,.835
Tyrone Hill,GSW,.415,4.9,74,66,2070,251,494,251,490,0,4,138,221,255,499,754,68,41,40,92,320,640,.508,.512,.000,.624
Chris Mullin,GSW,.415,4.9,46,46,1902,474,930,414,797,60,133,183,226,42,190,232,166,68,41,139,76,1191,.510,.519,.451,.810
Eddie Johnson,SEA,.671,4.8,82,0,1869,463,991,446,935,17,56,234,257,124,148,272,135,36,4,134,173,1177,.467,.477,.304,.911
Michael Adams,WSB,.268,4.6,70,70,2499,365,831,297,619,68,212,237,277,52,188,240,526,100,4,175,146,1035,.439,.480,.321,.856
Greg Anthony,NYK,.732,4.6,70,35,1699,174,419,170,389,4,30,107,159,42,128,170,398,113,12,104,141,459,.415,.437,.133,.673
Scott Brooks,HOU,.671,4.6,82,0,1516,183,385,142,286,41,99,112,135,22,77,99,243,79,3,72,136,519,.475,.497,.414,.830
Carl Herrera,HOU,.671,4.6,81,12,1800,240,444,240,442,0,2,125,176,148,306,454,61,47,35,92,190,605,.541,.543,.000,.710
Tom Chambers,PHO,.756,4.5,73,0,1723,320,716,309,688,11,28,241,288,96,249,345,101,43,23,92,212,892,.447,.449,.393,.837
Wayman Tisdale,SAC,.305,4.5,76,75,2283,544,1068,544,1066,0,2,175,231,127,373,500,108,52,47,117,277,1263,.509,.510,.000,.758
Hot Rod Williams,CLE,.659,4.5,67,13,2055,263,560,263,560,0,0,212,296,127,288,415,152,48,105,116,171,738,.470,.470,,.716
Kenny Anderson,NJN,.524,4.4,55,55,2010,370,850,363,825,7,25,180,232,51,175,226,449,96,11,153,140,927,.435,.440,.280,.776
