Player,Tm,W/L%,WS,G,GS,MP,FG,FGA,2P,2PA,3P,3PA,FT,FTA,ORB,DRB,TRB,AST,STL,BLK,TOV,PF,PTS,FG%,2P%,3P%,FT%
Karl Malone,UTA,.756,16.4,81,81,3030,780,1472,778,1466,2,6,628,825,189,645,834,316,96,70,247,237,2190,.530,.531,.333,.761
Michael Jordan,CHI,.756,15.8,82,82,3181,881,1893,851,1767,30,126,565,721,130,345,475,283,141,45,185,151,2357,.465,.482,.238,.784
David Robinson,SAS,.683,13.8,73,73,2457,544,1065,543,1061,1,4,485,660,239,536,775,199,64,192,202,204,1574,.511,.512,.250,.735
Tim Duncan,SAS,.683,12.8,82,82,3204,706,1287,706,1277,0,10,319,482,274,703,977,224,55,206,279,254,1731,.549,.553,.000,.662
Gary Payton,SEA,.744,12.5,82,82,3145,579,1278,445,881,134,397,279,375,77,299,376,679,185,18,229,195,1571,.453,.505,.338,.744
Reggie Miller,IND,.707,12.0,81,81,2795,516,1081,352,699,164,382,382,440,46,186,232,171,78,11,128,148,1578,.477,.504,.429,.868
Tim Hardaway,MIA,.671,11.7,81,81,3031,558,1296,403,854,155,442,257,329,48,251,299,672,136,16,224,200,1528,.431,.472,.351,.781
Dikembe Mutombo,ATL,.610,10.8,82,82,2917,399,743,399,743,0,0,303,452,276,656,932,82,34,277,168,254,1101,.537,.537,,.670
Vin Baker,SEA,.744,10.4,82,82,2944,631,1164,630,1157,1,7,311,526,286,370,656,152,91,86,174,278,1574,.542,.545,.143,.591
Detlef Schrempf,SEA,.744,10.4,78,78,2742,437,898,376,751,61,147,297,352,135,419,554,341,60,19,168,205,1232,.487,.501,.415,.844
Wesley Person,CLE,.573,10.3,82,82,3198,440,957,248,510,192,447,132,170,65,298,363,188,129,49,110,108,1204,.460,.486,.430,.776
Grant Hill,DET,.451,10.2,81,81,3294,615,1361,612,1340,3,21,479,647,93,530,623,551,143,53,285,196,1712,.452,.457,.143,.740
Shaquille O'Neal,LAL,.744,10.2,60,57,2175,670,1147,670,1147,0,0,359,681,208,473,681,142,39,144,175,193,1699,.584,.584,,.527
Steve Smith,ATL,.610,10.2,73,73,2857,489,1101,392,825,97,276,389,455,133,176,309,292,75,29,176,219,1464,.444,.475,.351,.855
Eddie Jones,LAL,.744,10.1,80,80,2910,486,1005,343,637,143,368,234,306,85,217,302,246,160,55,146,164,1349,.484,.538,.389,.765
Arvydas Sabonis,POR,.561,9.7,73,73,2333,407,826,377,711,30,115,323,405,149,580,729,218,65,80,190,267,1167,.493,.530,.261,.798
Kevin Garnett,MIN,.549,9.6,82,82,3222,635,1293,632,1277,3,16,245,332,222,564,786,348,139,150,192,224,1518,.491,.495,.188,.738
Jeff Hornacek,UTA,.756,9.5,80,80,2460,399,828,343,701,56,127,285,322,65,205,270,349,109,15,132,175,1139,.482,.489,.441,.885
Zydrunas Ilgauskas,CLE,.573,9.4,82,81,2379,454,876,453,872,1,4,230,302,279,444,723,71,52,135,146,288,1139,.518,.519,.250,.762
Antonio McDyess,PHO,.683,9.4,81,81,2441,497,927,497,925,0,2,231,329,206,407,613,106,100,135,142,292,1225,.536,.537,.000,.702
Anthony Mason,CHH,.622,9.3,81,80,3148,389,764,389,760,0,4,261,402,177,649,826,342,68,18,146,182,1039,.509,.512,.000,.649
Glen Rice,CHH,.622,9.3,82,82,3295,634,1386,504,1086,130,300,428,504,89,264,353,182,77,22,182,200,1826,.457,.464,.433,.849
Allen Iverson,PHI,.378,9.0,80,80,3150,649,1407,579,1172,70,235,390,535,86,210,296,494,176,25,244,200,1758,.461,.494,.298,.729
Charles Barkley,HOU,.500,8.6,68,41,2243,361,744,343,660,18,84,296,397,241,553,794,217,71,28,147,187,1036,.485,.520,.214,.746
Hersey Hawkins,SEA,.744,8.6,82,82,2597,280,636,155,335,125,301,177,204,71,263,334,221,148,17,102,153,862,.440,.463,.415,.868
Kerry Kittles,NJN,.524,8.4,77,76,2814,508,1154,398,891,110,263,202,250,132,230,362,176,132,37,106,152,1328,.440,.447,.418,.808
Brevin Knight,CLE,.573,8.4,80,76,2483,261,592,261,585,0,7,201,251,67,186,253,656,196,18,194,271,723,.441,.446,.000,.801
Jayson Williams,NJN,.524,8.4,65,65,2343,321,645,321,641,0,4,195,293,443,440,883,67,45,49,95,236,837,.498,.501,.000,.666
Sam Cassell,NJN,.524,8.3,75,72,2606,510,1156,495,1076,15,80,436,507,73,155,228,603,121,20,269,262,1471,.441,.460,.188,.860
Chris Webber,WAS,.512,8.3,71,71,2809,647,1341,582,1136,65,205,196,333,176,498,674,273,111,124,185,269,1555,.482,.512,.317,.589
Rod Strickland,WAS,.512,8.1,76,76,3020,490,1130,478,1082,12,48,357,492,112,293,405,801,126,25,266,182,1349,.434,.442,.250,.726
Jason Kidd,PHO,.683,8.0,82,82,3118,357,859,284,626,73,233,167,209,108,402,510,745,162,26,261,142,954,.416,.454,.313,.799
John Stockton,UTA,.756,8.0,64,64,1858,270,511,231,420,39,91,191,231,35,131,166,543,89,10,161,138,770,.528,.550,.429,.827
Mitch Richmond,SAC,.329,7.9,70,70,2569,543,1220,413,886,130,334,407,471,50,179,229,279,88,15,181,154,1623,.445,.466,.389,.864
Dennis Rodman,CHI,.756,7.8,80,66,2856,155,360,151,337,4,23,61,111,421,780,1201,230,47,18,147,238,375,.431,.448,.174,.550
Chris Mullin,IND,.707,7.6,82,82,2177,333,692,226,449,107,243,154,164,38,211,249,186,95,39,117,186,927,.481,.503,.440,.939
Bo Outlaw,ORL,.500,7.6,82,76,2953,301,543,300,539,1,4,180,313,255,382,637,216,107,181,175,260,783,.554,.557,.250,.575
Rasheed Wallace,POR,.561,7.6,77,77,2896,466,875,458,836,8,39,184,278,132,346,478,195,75,88,167,268,1124,.533,.548,.205,.662
P.J. Brown,MIA,.671,7.5,74,74,2362,278,590,278,590,0,0,151,197,235,400,635,103,66,98,97,264,707,.471,.471,,.766
Michael Finley,DAL,.244,7.5,82,82,3394,675,1505,588,1261,87,244,326,416,150,288,438,405,132,30,219,163,1763,.449,.466,.357,.784
Mark Jackson,IND,.707,7.5,82,82,2413,249,598,206,461,43,137,137,180,67,255,322,713,84,2,174,132,678,.416,.447,.314,.761
Christian Laettner,ATL,.610,7.5,74,49,2282,354,730,348,703,6,27,306,354,142,345,487,190,71,73,183,246,1020,.485,.495,.222,.864
Alonzo Mourning,MIA,.671,7.5,58,56,1939,403,732,403,732,0,0,309,465,193,365,558,52,40,130,179,208,1115,.551,.551,,.665
Antonio Davis,IND,.707,7.4,82,12,2191,254,528,254,525,0,3,277,398,192,368,560,61,45,72,103,234,785,.481,.484,.000,.696
Ron Harper,CHI,.756,7.2,82,82,2284,293,665,277,581,16,84,162,216,107,183,290,241,108,48,91,181,764,.441,.477,.190,.750
Dale Davis,IND,.707,7.1,78,78,2174,273,498,273,498,0,0,80,172,233,378,611,70,51,87,73,209,626,.548,.548,,.465
Horace Grant,ORL,.500,7.1,76,76,2803,393,857,393,850,0,7,135,199,228,390,618,172,81,79,88,180,921,.459,.462,.000,.678
Voshon Lenard,MIA,.671,7.1,81,81,2621,363,854,210,476,153,378,141,179,72,220,292,180,58,16,99,219,1020,.425,.441,.405,.788
Clifford Robinson,PHO,.683,7.1,80,64,2359,429,895,402,811,27,84,248,360,152,258,410,170,92,90,140,249,1133,.479,.496,.321,.689
Nick Van Exel,LAL,.744,7.1,64,46,2053,311,743,188,427,123,316,136,172,31,163,194,442,64,6,104,120,881,.419,.440,.389,.791
Charlie Ward,NYK,.524,7.1,82,82,2317,235,516,154,301,81,215,91,113,32,242,274,466,144,37,175,195,642,.455,.512,.377,.805
Ray Allen,MIL,.439,7.0,82,82,3287,563,1315,429,947,134,368,342,391,127,278,405,356,111,12,263,244,1602,.428,.453,.364,.875
Toni Kukoc,CHI,.756,7.0,74,52,2235,383,841,320,667,63,174,155,219,121,206,327,314,76,37,154,149,984,.455,.480,.362,.708
Charles Oakley,NYK,.524,7.0,79,79,2734,307,698,307,692,0,6,97,114,218,506,724,201,123,22,126,280,711,.440,.444,.000,.851
Shareef Abdur-Rahim,VAN,.232,6.9,82,82,2950,653,1347,632,1296,21,51,502,640,227,354,581,213,89,76,257,201,1829,.485,.488,.412,.784
Bison Dele,DET,.451,6.9,78,78,2619,531,1040,530,1037,1,3,198,280,223,472,695,94,67,55,181,252,1261,.511,.511,.333,.707
Larry Johnson,NYK,.524,6.9,70,70,2412,429,884,414,821,15,63,214,283,175,226,401,150,40,13,127,193,1087,.485,.504,.238,.756
Clyde Drexler,HOU,.500,6.8,70,70,2473,452,1059,346,725,106,334,277,346,105,241,346,382,126,42,189,193,1287,.427,.477,.317,.801
Shawn Kemp,CLE,.573,6.8,80,80,2769,518,1164,516,1156,2,8,404,556,219,526,745,197,108,90,271,310,1442,.445,.446,.250,.727
Avery Johnson,SAS,.683,6.7,75,73,2674,321,671,319,658,2,13,122,168,30,120,150,591,84,18,165,140,766,.478,.485,.154,.726
Theo Ratliff,TOT,,6.7,82,67,2447,306,597,306,597,0,0,197,281,221,326,547,57,50,258,116,292,809,.513,.513,,.701
Robert Horry,LAL,.744,6.6,72,71,2192,200,420,181,327,19,93,117,169,186,356,542,163,112,94,99,238,536,.476,.554,.204,.692
Scottie Pippen,CHI,.756,6.6,44,44,1652,315,704,254,512,61,192,150,193,53,174,227,254,79,43,109,116,841,.447,.496,.318,.777
Adam Keefe,UTA,.756,6.5,80,75,2047,229,424,229,424,0,0,162,200,179,259,438,89,52,24,71,172,620,.540,.540,,.810
Danny Manning,PHO,.683,6.5,70,11,1794,390,756,390,749,0,7,167,226,110,282,392,139,71,46,100,201,947,.516,.521,.000,.739
Tracy Murray,WAS,.512,6.5,82,12,2227,449,1007,291,604,158,403,182,209,75,202,277,84,67,25,102,167,1238,.446,.482,.392,.871
Ervin Johnson,MIL,.439,6.4,81,81,2261,253,471,253,471,0,0,143,238,242,443,685,59,79,158,117,321,649,.537,.537,,.601
Kobe Bryant,LAL,.744,6.3,79,1,2056,391,913,316,693,75,220,363,457,79,163,242,199,74,40,157,180,1220,.428,.456,.341,.794
Brian Grant,POR,.561,6.3,61,49,1921,283,557,283,556,0,1,171,228,197,358,555,86,44,45,110,184,737,.508,.509,.000,.750
Allan Houston,NYK,.524,6.1,82,82,2848,571,1277,489,1064,82,213,285,335,43,231,274,212,63,24,200,207,1509,.447,.460,.385,.851
Sam Mitchell,MIN,.549,6.1,81,33,2239,371,800,356,757,15,43,243,292,118,267,385,107,64,22,66,200,1000,.464,.470,.349,.832
Rik Smits,IND,.707,6.1,73,69,2085,514,1038,514,1035,0,3,188,240,127,378,505,101,40,88,134,243,1216,.495,.497,.000,.783
Dale Ellis,SEA,.744,6.0,79,0,1939,348,700,221,426,127,274,111,142,51,133,184,89,60,5,74,128,934,.497,.519,.464,.782
Alan Henderson,ATL,.610,6.0,69,33,2000,365,753,362,747,3,6,253,388,200,242,442,73,42,36,110,175,986,.485,.485,.500,.652
Bryon Russell,UTA,.756,6.0,82,7,2219,226,525,153,311,73,214,213,278,78,248,326,101,90,31,81,229,738,.430,.492,.341,.766
Kevin Willis,HOU,.500,6.0,81,74,2528,531,1041,530,1034,1,7,242,305,232,447,679,78,55,38,170,235,1305,.510,.513,.143,.793
Vlade Divac,CHH,.622,5.9,64,41,1805,267,536,264,522,3,14,130,188,183,335,518,172,83,94,114,179,667,.498,.506,.214,.691
Joe Dumars,DET,.451,5.9,72,72,2326,329,791,171,365,158,426,127,154,14,90,104,253,44,2,84,99,943,.416,.468,.371,.825
Matt Geiger,CHH,.622,5.9,78,42,1839,358,709,357,698,1,11,168,236,196,325,521,78,68,87,111,191,885,.505,.511,.091,.712
Kendall Gill,NJN,.524,5.9,81,81,2733,418,974,392,873,26,101,225,327,112,279,391,200,156,64,124,268,1087,.429,.449,.257,.688
Isaiah Rider,POR,.561,5.8,74,66,2786,551,1302,416,882,135,420,221,267,99,247,346,231,55,19,187,188,1458,.423,.472,.321,.828
David Wesley,CHH,.622,5.8,81,81,2845,383,864,324,694,59,170,229,288,49,164,213,529,140,30,226,229,1054,.443,.467,.347,.795
Dana Barros,BOS,.439,5.6,80,15,1686,281,609,181,363,100,246,122,144,28,125,153,286,83,6,107,124,784,.461,.499,.407,.847
Mookie Blaylock,ATL,.610,5.6,70,69,2700,368,938,278,604,90,334,95,134,81,260,341,469,183,21,176,122,921,.392,.460,.269,.709
Tyrone Corbin,ATL,.610,5.5,79,79,2699,328,747,279,606,49,141,101,128,78,284,362,173,105,7,86,197,806,.439,.460,.348,.789
Derek Anderson,CLE,.573,5.3,66,13,1839,239,586,222,502,17,84,275,315,55,132,187,227,86,13,128,136,770,.408,.442,.202,.873
Nick Anderson,ORL,.500,5.3,58,44,1701,343,754,266,540,77,214,127,199,98,199,297,119,72,23,85,98,890,.455,.493,.360,.638
Rick Fox,LAL,.744,5.3,82,82,2709,363,771,277,506,86,265,171,230,78,280,358,276,100,48,201,309,983,.471,.547,.325,.743
Armen Gilliam,MIL,.439,5.3,82,25,2114,327,676,327,672,0,4,267,333,146,293,439,104,65,37,148,177,921,.484,.487,.000,.802
Dan Majerle,MIA,.671,5.3,72,22,1928,184,439,73,144,111,295,40,51,48,220,268,157,68,15,65,139,519,.419,.507,.376,.784
Stephon Marbury,MIN,.549,5.3,82,81,3112,513,1237,418,933,95,304,329,450,58,172,230,704,104,7,256,222,1450,.415,.448,.313,.731
A.C. Green,DAL,.244,5.2,82,68,2649,242,534,242,530,0,4,116,162,219,449,668,123,78,27,68,157,600,.453,.457,.000,.716
Terry Porter,MIN,.549,5.2,82,8,1786,259,577,167,344,92,233,167,195,37,131,168,271,63,16,104,103,777,.449,.485,.395,.856
Terrell Brandon,MIL,.439,5.1,50,48,1784,339,731,308,638,31,93,132,156,23,153,176,387,111,17,145,120,841,.464,.483,.333,.846
Chris Mills,NYK,.524,5.1,80,29,2183,292,675,252,538,40,137,152,189,120,288,408,133,45,30,107,218,776,.433,.468,.292,.804
Tom Gugliotta,MIN,.549,5.0,41,41,1582,319,635,317,618,2,17,183,223,106,250,356,167,61,22,109,102,823,.502,.513,.118,.821
Lamond Murray,LAC,.207,4.9,79,65,2579,473,984,419,831,54,153,220,294,172,312,484,142,118,54,171,193,1220,.481,.504,.353,.748
Bryant Reeves,VAN,.232,4.9,74,74,2527,492,941,492,937,0,4,223,316,196,389,585,155,39,80,156,278,1207,.523,.525,.000,.706
Tyrone Hill,MIL,.439,4.8,57,56,2064,208,418,208,417,0,1,155,255,212,396,608,88,67,30,106,230,571,.498,.499,.000,.608
Steve Nash,PHO,.683,4.8,76,9,1664,268,584,187,389,81,195,74,86,32,128,160,262,63,4,98,145,691,.459,.481,.415,.860
