Player,Tm,W/L%,WS,G,GS,MP,FG,FGA,2P,2PA,3P,3PA,FT,FTA,ORB,DRB,TRB,AST,STL,BLK,TOV,PF,PTS,FG%,2P%,3P%,FT%
LeBron James,MIA,.805,19.3,76,76,2877,765,1354,662,1100,103,254,403,535,97,513,610,551,129,67,226,110,2036,.565,.602,.406,.753
Kevin Durant,OKC,.732,18.9,81,81,3119,731,1433,592,1099,139,334,679,750,46,594,640,374,116,105,280,143,2280,.510,.539,.416,.905
Chris Paul,LAC,.683,13.9,70,70,2335,412,856,336,624,76,232,286,323,53,209,262,678,169,10,159,143,1186,.481,.538,.328,.885
James Harden,HOU,.549,12.8,78,78,2985,585,1337,406,851,179,486,674,792,62,317,379,455,142,38,295,178,2023,.438,.477,.368,.851
Russell Westbrook,OKC,.732,11.6,82,82,2861,673,1535,576,1235,97,300,460,575,111,317,428,607,145,24,273,189,1903,.438,.466,.323,.800
Marc Gasol,MEM,.683,11.5,80,80,2796,429,869,428,855,1,14,268,316,184,438,622,318,80,139,157,255,1127,.494,.501,.071,.848
Stephen Curry,GSW,.573,11.2,78,78,2983,626,1388,354,788,272,600,262,291,59,255,314,539,126,12,240,198,1786,.451,.449,.453,.900
Kobe Bryant,LAL,.549,10.9,78,78,3013,738,1595,606,1188,132,407,525,626,66,367,433,469,106,25,287,173,2133,.463,.510,.324,.839
Deron Williams,BRK,.598,10.9,78,78,2842,495,1124,326,677,169,447,317,369,29,203,232,604,75,30,218,194,1476,.440,.482,.378,.859
Blake Griffin,LAC,.683,10.6,80,80,2598,577,1072,572,1044,5,28,281,426,186,476,662,299,97,50,185,231,1440,.538,.548,.179,.660
Mike Conley,MEM,.683,9.9,80,80,2757,414,940,308,647,106,293,234,282,43,182,225,487,174,24,189,171,1168,.440,.476,.362,.830
George Hill,IND,.605,9.7,76,76,2620,386,871,256,518,130,353,174,213,47,237,284,355,81,26,116,134,1076,.443,.494,.368,.817
Dwyane Wade,MIA,.805,9.6,69,69,2391,569,1093,552,1027,17,66,308,425,86,258,344,352,128,56,194,140,1463,.521,.537,.258,.725
Carmelo Anthony,NYK,.659,9.5,67,67,2482,669,1489,512,1075,157,414,425,512,134,326,460,171,52,32,175,205,1920,.449,.476,.379,.830
Serge Ibaka,OKC,.732,9.4,80,80,2486,446,778,426,721,20,57,143,191,222,395,617,43,28,242,125,213,1055,.573,.591,.351,.749
Tyson Chandler,NYK,.659,9.3,66,66,2164,255,400,255,400,0,0,179,258,269,434,703,62,42,75,87,188,689,.638,.638,,.694
Tony Parker,SAS,.707,9.3,66,66,2174,519,995,495,927,24,68,279,330,18,180,198,499,54,6,170,92,1341,.522,.534,.353,.845
David Lee,GSW,.573,9.1,79,79,2907,602,1160,602,1156,0,4,255,320,218,668,886,279,67,22,207,246,1459,.519,.521,.000,.797
David West,IND,.605,9.1,73,73,2435,502,1009,498,990,4,19,242,315,145,418,563,213,74,69,157,149,1250,.498,.503,.211,.768
Chris Bosh,MIA,.805,9.0,74,74,2454,485,907,464,833,21,74,241,302,131,370,501,123,66,101,128,168,1232,.535,.557,.284,.798
Paul George,IND,.605,9.0,79,79,2972,493,1176,323,707,170,469,221,274,88,515,603,327,143,51,233,227,1377,.419,.457,.362,.807
Brook Lopez,BRK,.598,9.0,74,74,2253,570,1094,570,1093,0,1,297,392,208,304,512,70,33,154,131,152,1437,.521,.522,.000,.758
Al Horford,ATL,.537,8.8,74,74,2756,576,1060,573,1054,3,6,134,208,195,562,757,240,78,78,147,163,1289,.543,.544,.500,.644
Tim Duncan,SAS,.707,8.3,69,69,2078,490,976,488,969,2,7,245,300,124,562,686,184,50,183,147,117,1227,.502,.504,.286,.817
Tiago Splitter,SAS,.707,8.2,81,58,1997,315,563,315,561,0,2,208,285,144,371,515,130,63,64,100,161,838,.560,.561,.000,.730
Zach Randolph,MEM,.683,7.9,76,75,2607,471,1024,469,1001,2,23,225,300,310,544,854,108,61,31,150,180,1169,.460,.469,.087,.750
Kenneth Faried,DEN,.695,7.8,80,80,2248,380,689,380,689,0,0,163,266,260,474,734,77,81,83,113,234,923,.552,.552,,.613
Al Jefferson,UTA,.524,7.7,78,78,2578,611,1236,609,1219,2,17,167,217,156,564,720,164,80,89,105,170,1391,.494,.500,.118,.770
Dwight Howard,LAL,.549,7.6,76,76,2722,470,813,469,807,1,6,355,721,251,694,945,108,84,186,225,291,1296,.578,.581,.167,.492
Paul Millsap,UTA,.524,7.6,78,78,2375,429,875,416,836,13,39,264,356,177,377,554,201,102,80,138,232,1135,.490,.498,.333,.742
Jose Calderon,TOT,,7.4,73,58,2160,312,635,182,353,130,282,72,80,20,156,176,518,58,8,126,99,826,.491,.516,.461,.900
Ty Lawson,DEN,.695,7.4,73,71,2513,448,971,363,739,85,232,235,311,36,162,198,501,107,8,182,135,1216,.461,.491,.366,.756
Thaddeus Young,PHI,.415,7.4,76,76,2629,509,958,508,950,1,8,108,188,182,389,571,125,133,55,90,191,1127,.531,.535,.125,.574
Amir Johnson,TOR,.415,7.3,81,38,2325,336,606,331,593,5,13,136,187,227,384,611,122,81,110,117,301,813,.554,.558,.385,.727
Joakim Noah,CHI,.549,7.3,66,64,2426,303,630,303,625,0,5,178,237,260,473,733,262,78,141,176,185,784,.481,.485,.000,.751
LaMarcus Aldridge,POR,.402,7.2,74,74,2790,638,1318,636,1304,2,14,282,348,175,495,670,192,62,91,143,187,1560,.484,.488,.143,.810
Danilo Gallinari,DEN,.695,7.2,71,71,2309,364,871,229,509,135,362,286,348,65,302,367,176,64,36,111,130,1149,.418,.450,.373,.822
Paul Pierce,BOS,.506,7.2,77,77,2575,476,1092,331,710,145,382,333,423,45,442,487,370,84,30,214,210,1430,.436,.466,.380,.787
Jimmy Butler,CHI,.549,7.0,82,20,2134,239,512,199,407,40,105,187,233,136,192,328,115,78,31,62,97,705,.467,.489,.381,.803
Kevin Martin,OKC,.732,7.0,77,0,2136,350,778,192,407,158,371,219,246,31,147,178,106,72,8,101,138,1077,.450,.472,.426,.890
Chandler Parsons,HOU,.549,7.0,76,76,2758,456,939,304,544,152,395,113,155,79,325,404,269,75,32,147,148,1177,.486,.559,.385,.729
J.J. Hickson,POR,.402,6.9,80,80,2323,418,744,418,742,0,2,182,268,266,562,828,88,48,51,145,160,1018,.562,.563,.000,.679
Thabo Sefolosha,OKC,.732,6.8,81,81,2229,224,466,116,208,108,258,57,69,58,259,317,125,103,44,64,177,613,.481,.558,.419,.826
Ersan Ilyasova,MIL,.463,6.7,73,54,2012,371,803,276,589,95,214,125,157,154,366,520,117,68,36,75,185,962,.462,.469,.444,.796
Nikola Pekovic,MIN,.378,6.7,62,62,1959,385,741,385,741,0,0,241,324,230,315,545,53,43,50,101,143,1011,.520,.520,,.744
J.R. Smith,NYK,.659,6.7,80,0,2678,527,1249,372,813,155,436,237,311,64,361,425,218,100,24,134,226,1446,.422,.458,.356,.762
Ryan Anderson,NOH,.329,6.5,81,22,2503,472,1115,259,558,213,557,152,180,191,328,519,97,42,31,97,179,1309,.423,.464,.382,.844
Kosta Koufos,DEN,.695,6.5,81,81,1817,295,508,295,507,0,1,58,104,211,351,562,32,44,103,53,246,648,.581,.582,.000,.558
Kyle Korver,ATL,.537,6.4,74,60,2259,277,601,88,187,189,414,67,78,23,270,293,146,70,37,70,170,810,.461,.471,.457,.859
Matt Barnes,LAC,.683,6.3,80,4,2058,312,675,201,350,111,325,87,117,111,255,366,123,82,63,90,233,822,.462,.574,.342,.744
Luol Deng,CHI,.549,6.3,75,75,2903,466,1093,391,860,75,233,230,282,162,314,476,222,81,32,144,105,1237,.426,.455,.322,.816
Martell Webster,WAS,.354,6.3,76,62,2200,281,636,142,307,139,329,168,198,53,241,294,143,49,17,90,166,869,.442,.463,.422,.848
DeAndre Jordan,LAC,.683,6.2,82,82,2010,314,488,314,488,0,0,96,249,210,384,594,28,48,112,100,192,724,.643,.643,,.386
Carl Landry,GSW,.573,6.2,81,2,1876,325,602,324,599,1,3,223,273,180,303,483,65,35,31,115,190,874,.540,.541,.333,.817
Kawhi Leonard,SAS,.707,6.2,58,57,1810,260,526,195,352,65,174,104,126,63,283,346,93,97,32,62,99,689,.494,.554,.374,.825
Anthony Davis,NOH,.329,6.1,64,60,1846,349,676,349,670,0,6,169,225,165,357,522,63,75,112,89,158,867,.516,.521,.000,.751
Roy Hibbert,IND,.605,6.1,79,79,2269,385,859,384,855,1,4,166,224,296,360,656,113,39,206,162,279,937,.448,.449,.250,.741
Jeff Teague,ATL,.537,6.1,80,78,2628,439,974,350,726,89,248,199,226,25,155,180,579,117,28,230,181,1166,.451,.482,.359,.881
Vince Carter,DAL,.500,6.0,81,3,2093,372,855,210,456,162,399,182,223,58,276,334,194,74,44,106,226,1088,.435,.461,.406,.816
Andrei Kirilenko,MIN,.378,6.0,64,64,2034,284,560,249,440,35,120,188,250,102,260,362,177,96,62,119,82,791,.507,.566,.292,.752
Larry Sanders,MIL,.463,6.0,71,55,1937,306,605,306,603,0,2,84,136,224,448,672,83,53,201,87,233,696,.506,.507,.000,.618
Danny Green,SAS,.707,5.9,80,80,2201,297,663,120,250,177,413,67,79,36,208,244,141,92,54,94,124,838,.448,.480,.429,.848
Greg Monroe,DET,.354,5.9,81,81,2687,514,1058,514,1054,0,4,270,392,236,541,777,281,105,55,234,190,1298,.486,.488,.000,.689
Nate Robinson,CHI,.549,5.9,82,23,2086,399,921,258,573,141,348,135,169,29,155,184,358,85,10,144,207,1074,.433,.450,.405,.799
Nicolas Batum,POR,.402,5.8,73,73,2807,352,833,187,389,165,444,178,210,97,315,412,360,91,83,190,139,1047,.423,.481,.372,.848
Brandon Jennings,MIL,.463,5.8,80,80,2897,497,1247,324,786,173,461,230,281,59,187,246,521,125,10,203,155,1397,.399,.412,.375,.819
Damian Lillard,POR,.402,5.8,82,82,3167,553,1288,368,785,185,503,271,321,42,215,257,531,74,19,243,172,1562,.429,.469,.368,.844
Carlos Boozer,CHI,.549,5.7,79,79,2546,544,1140,544,1138,0,2,193,264,175,596,771,179,66,28,176,239,1281,.477,.478,.000,.731
Goran Dragic,PHO,.305,5.7,77,77,2581,401,906,313,630,88,276,244,326,60,178,238,569,124,26,212,214,1134,.443,.497,.319,.748
Nikola Vucevic,ORL,.244,5.7,77,77,2559,461,889,461,886,0,3,86,126,273,644,917,143,61,79,141,218,1008,.519,.520,.000,.683
Darren Collison,DAL,.500,5.6,81,47,2372,341,724,293,588,48,136,242,275,31,188,219,415,100,8,173,139,972,.471,.498,.353,.880
Kevin Garnett,BOS,.506,5.6,68,68,2022,422,850,420,834,2,16,158,201,75,455,530,159,78,62,110,154,1004,.496,.504,.125,.786
Andre Iguodala,DEN,.695,5.6,80,80,2779,396,879,305,592,91,287,155,270,82,341,423,433,139,52,206,127,1038,.451,.515,.317,.574
Jarrett Jack,GSW,.573,5.6,79,4,2349,387,857,305,654,82,203,167,198,21,222,243,439,60,11,157,134,1023,.452,.466,.404,.843
Robin Lopez,NOH,.329,5.6,82,82,2136,384,719,384,719,0,0,161,207,226,236,462,64,32,128,110,167,929,.534,.534,,.778
Kyle Lowry,TOR,.415,5.6,68,52,2020,250,623,149,344,101,279,190,239,56,265,321,435,94,24,157,218,791,.401,.433,.362,.795
Omer Asik,HOU,.549,5.5,82,82,2464,332,614,332,613,0,1,168,299,275,681,956,75,46,87,173,223,832,.541,.542,.000,.562
Lance Stephenson,IND,.605,5.5,78,72,2278,275,598,213,410,62,188,75,115,47,257,304,223,81,16,109,162,687,.460,.520,.330,.652
Ray Allen,MIA,.805,5.4,79,0,2035,292,651,153,319,139,332,140,158,40,177,217,135,67,15,103,129,863,.449,.480,.419,.886
Jamal Crawford,LAC,.683,5.4,76,0,2230,445,1016,296,620,149,396,216,248,22,106,128,193,79,13,146,71,1255,.438,.477,.376,.871
Ed Davis,TOT,,5.4,81,28,1631,260,482,260,482,0,0,103,167,152,308,460,63,38,85,63,191,623,.539,.539,,.617
Gordon Hayward,UTA,.524,5.4,72,27,2104,336,773,234,527,102,246,243,294,51,174,225,213,58,38,120,125,1017,.435,.444,.415,.827
Jason Kidd,NYK,.659,5.4,76,48,2043,152,409,38,84,114,325,40,48,50,273,323,249,125,25,76,125,458,.372,.452,.351,.833
Jeremy Lin,HOU,.549,5.4,82,82,2640,396,897,309,640,87,257,216,275,32,215,247,497,134,29,236,205,1095,.441,.483,.339,.785
Andre Miller,DEN,.695,5.4,82,11,2151,303,632,286,568,17,64,163,194,60,178,238,484,73,11,172,159,786,.479,.504,.266,.840
Kyrie Irving,CLE,.293,5.3,59,59,2048,484,1070,375,791,109,279,248,290,34,182,216,350,89,21,191,146,1325,.452,.474,.391,.855
Shawn Marion,DAL,.500,5.3,67,67,2010,355,690,332,617,23,73,79,101,146,379,525,163,75,47,103,111,812,.514,.538,.315,.782
Mario Chalmers,MIA,.805,5.2,77,77,2068,227,529,104,228,123,301,89,112,19,152,171,273,118,12,119,196,666,.429,.456,.409,.795
Nick Collison,OKC,.732,5.2,81,2,1583,176,296,176,292,0,4,60,78,123,210,333,121,51,30,69,197,412,.595,.603,.000,.769
Tristan Thompson,CLE,.293,5.2,82,82,2564,390,799,390,796,0,3,177,291,306,467,773,108,60,71,123,234,957,.488,.490,.000,.608
Tony Allen,MEM,.683,5.1,79,79,2109,284,638,281,614,3,24,134,187,121,242,363,98,119,44,94,211,705,.445,.458,.125,.717
Joe Johnson,BRK,.598,5.1,72,72,2642,445,1052,297,657,148,395,132,161,53,165,218,253,49,14,123,99,1170,.423,.452,.375,.820
Dirk Nowitzki,DAL,.500,5.0,53,47,1661,343,728,278,571,65,157,166,193,37,326,363,132,38,37,70,93,917,.471,.487,.414,.860
Isaiah Thomas,SAC,.341,5.0,79,62,2122,366,832,251,511,115,321,253,287,29,132,161,316,67,3,140,167,1100,.440,.491,.358,.882
Andray Blatche,BRK,.598,4.9,82,8,1555,346,676,343,654,3,22,148,216,161,256,417,85,86,54,123,163,843,.512,.524,.136,.685
JaVale McGee,DEN,.695,4.9,79,0,1433,303,527,302,526,1,1,110,186,158,223,381,24,30,157,90,184,717,.575,.574,1.000,.591
Dorell Wright,PHI,.415,4.9,79,8,1783,237,599,102,238,135,361,120,141,42,260,302,150,62,35,64,98,729,.396,.429,.374,.851
Jared Dudley,PHO,.305,4.8,79,50,2170,313,669,207,398,106,271,129,162,79,166,245,203,75,8,101,128,861,.468,.520,.391,.796
Kemba Walker,CHA,.256,4.8,82,82,2859,526,1244,419,912,107,332,296,371,60,223,283,471,160,31,200,153,1455,.423,.459,.322,.798
Brandon Bass,BOS,.506,4.7,81,69,2239,286,589,286,587,0,2,129,150,129,296,425,84,44,64,80,188,701,.486,.487,.000,.860
